111111111111111111111111
120000000011111111103111
100011010011111000001111
100111010013000011111111
100111010000011111111111
100111011111011111000011
101101111111011101011111
100000000011000001011111
111111111011111011011111
111111111011111000001111
111111000300000011100011
111111011111111111100011
110000011100001111100131
100011111101100011100001
101000000001111011101111
101101101111111011101111
103101101111111000000001
111101101111011100110001
130001100000000000110021
111111111111111111111111