111111111111111111111111
120000000011111111100111
100011010011111000001111
100111010010000011111111
100111010000011111111111
100111011111011111000011
101101111111011101011111
100000000011000001011111
111111111011111011011111
111111111011111000011111
111111000000000011111111
111111011111111111111111
110000011100001111111111
100011111101100011111111
101000000001111011111111
101101101111111011111111
100101101111111000000001
111101101111011100110001
100001100000000000110021
111111111111111111111111