1111111111
1000000001
1000010001
1000210001
1000100001
1000100001
1000010001
1000010111
1000010021
1111111111